24
************************************************************************************
*************************************************************%%%%%%%%%%%%%**********
***************%%%%%%%%%%%%%%%%%%%%%%%%%%%%%%%%%%%%%%*******************************
***************%************************************%*******************************
***************%************************************%%******************************
***************%*************************************%*******************%**********
***************%*************************************%*******************%**********
***************%*************************************%%%%****************%**********
***************%**********%%%%%%%%%%%%%%%%%%%%%%********%****************%**********
***************%**********%********************%********%****************%**********
***************%**********%********************%********%%%%*************%%%********
***************%**********%********************%***********%***************%********
***************%**********%********************%***********%***************%********
***************%**********%********************%***********%***************%********
***************%**********%********************%***********%***************%********
***************%**********%********************%***********%***************%********
***************%**********%********************%***********%***************%********
***************%**********%*********%%%%%%%%%%%%********%%%%************%%%%********
***************%**********%*********%*******************%***************%***********
***************%**********%*********%****%%%%%%%%%%%%%%%%***************%***********
***************%**********%*********%****%*****************************%%***********
***************%**********%*********%****%%%%%%%%%%%%%%%%%%%%%%%%%%%%%%%%************
************************************************************************************
************************************************************************************