20
************************************************************************************
************************************************************************************
************************************************************************************
************************************************************************************ 
************************************************************************************  
************#********************#############*****************#**************#***** 
************#********************************#*****************#**************#*****    
************#********************************#*****************#**************#*****
************#********************************#*****************#**************#*****
************########################*********#*****************#**************#*****
***********************************#*********#*****************#**************#*****
***********************************#*********#*****************#**************#*****
*******#####***********************#*********#*****************######****######*****
*******#***#########################*********#**********************#****#**********
*******#*************************************#**********************#****#**********
*******#*************************************#**********************######**********
*******#######################################**************************************
************************************************************************************
************************************************************************************
************************************************************************************